1111111111111111111111111111111111
1000000000000C00000X000000X0000001
1010010101100C00101001000000010101
101001000C101010001101000000010101
1P000000000100000E1000000000000001
1000000000000C000X0000000000X00001
1000000000000C00000000000000000001
1000000000000C0000000X000000000001
10000X0000000C000000000000000000X1
1000000000000C00000000000000X00001
1111111111111111111111111111111111