1111111111111111111111111111111111
1000000000000C00000000000000000001
1010010101100C00101001000000010101
101001000C101010011101000000010101
1P000000000100001E0000000000000001
1000000000000C00010000000000000001
1000000000000C00000000000000000001
1000000000000C00000000000000000001
1000000000000C00000000000000000001
1000000000000C00000000000000000001
1111111111111111111111111111111111