1111111111111111111111111111111111
1000001111000000000000000000000001
10P00011010000000000000000C0000001
1000001101000000000000000000000001
10000C1101000000000000000000000001
1000001101000000000000000000000001
1000001101000000000000000000000001
1000001101000000000000000000000001
1000001111000000000000000000000001
1000000000000000000000000000000001
1000000000000000000000000000000001
1000000000000000000000000000000001
1000000000000000000C00000000000001
1000000000000000000000000000000001
1000000000000000000000000000000001
10000000000000000000000000000C0001
1000000000000000000000000000000001
1000000C00000000000000000000000E01
1000000000000000000000000000000001
1111111111111111111111111111111111