11111111
1CEP1001
1C101001
10111001
101000C1
10101001
1C001001
1C1X1001
11111111