111111111111111111111111111111111
11010101010101P101010101010101011
1C000X00000000000000X000000000001
110101010101010101010101010101011
1000000000X0000000000X000000000C1
110101010101010101010101010101011
1C000X000000000000000000X00000001
110101010101010101010101010101011
1X000000X00000000000000X000000001
110101010101010101010101010101011
1C00000X000000000000X000000000011
110101010101010101010101010101011
1000000000000000X00000000000000C1
110101010101010101010101010101011
1000000X0000000000000000000X00001
110101010101010101010101010101011
1C000X0000000000000000000000000C1
110101C1010101E101010101010101C11
111111111111111111111111111111111